1111111111
100P000001
1C00011001
10000E1001
1000011001
1111111111