1111111111
1C00000001
10000R0001
100P0E0001
1000000001
1111111111 