1111111111
1C00000001
1000111C01
100P1E1001
1000111001
1111111111 