1111111111
1000000001
1000011001
10000E1001
1000011001
1111111111 