1111111111
1C00000001
1000000001
100P0E0001
100000000111
1111111111 