1111111111111111
1C000000P0000001
1000000000000001
1000000000E00001
1000000000000001
1111111111111111
